####################### #
#.....................#.#
#.#########.#.#######.#.#
#.#.......#...#.......#.#
#.####.####.#.####.####.#
#.......................#
#.######.#######.######.#
#......#....#....#......#
######.#### # ####.######
     #.#         #.#     
######.# ##---## #.######
.......  #☻☻☻☻☻#  .......
######.# ####### #.######
     #.#         #.#     
######.# ####### #.######
#...........#...........#
#.####.####.#.####.####.#
#....#......☺......#....#
####.######.#.######.####
#......#....#....#......#
#.#########.#.#######.#.#
#.....................#.#
####################### #