#########################
#...........#...........#
#.####.####.#.####.####.#
#.#  #.#  #.#.#  #.#  #.#
#.####.####.#.####.####.#
#.......................#
#.####.#.#######.#.####.#
#......#....#....#......#
######.#### # ####.######
     #.#         #.#     
######.# ##---## #.######
      .  #☻☻☻☻☻#  .      
######.# ####### #.######
     #.#         #.#     
######.# ####### #.######
#...........#...........#
#.####.####.#.####.####.#
#....#......☺......#....#
####.#.#.#######.#.#.####
#......#....#....#......#
#.#########.#.#########.#
#.......................#
#########################